Elephant = ช้าง
Rabbit = กระต่าย
Dolphin = ปลาโลมา
Pigeon = นกพิราบ
Kangaroo = จิงโจ้
Penguin = เพนกวิน
Donkey = ลา
Otter = นาก
Peacock = นกยูง
Leopard = เสือดาว
Parrot = นกแก้ว
Buffalo = ควาย
Jaguar = เสือจากัวร์
Hyena = ไฮยีน่า
Cheetah = เสือชีตาห์
Raccoon = แรคคูน
Porcupine = เม่น
Turkey = ไก่งวง
Spider = แมงมุม
Octopus = ปลาหมึกยักษ์
Chameleon = กิ้งก่า
Mongoose = พังพอน
Alligator = จระเข้
Shark = ฉลาม
Hedgehog = เม่นแคระ
Cricket = จิ้งหรีด
Bison = กระทิง
Giraffe = ยีราฟ
Gorilla = กอริลลา
Lobster = กุ้งล็อบสเตอร์
Salmon = ปลาแซลมอน
Piranha = ปลาปิรันย่า
Koala = โคอาลา
Beetle = แมลงเต่าทอง
Vulture = นกแร้ง
Eagle = นกอินทรี
Falcon = นกเหยี่ยว
Manatee = พะยูน
Hamster = แฮมสเตอร์
Chimpanzee = ลิงชิมแปนซี
Platypus = ตุ่นปากเป็ด
Woodpecker = นกหัวขวาน
Anaconda = งูอนาคอนดา
Hummingbird = นกฮัมมิ่งเบิร์ด
Goldfish = ปลาทอง
Rhino = แรด
Scorpion = แมงป่อง
Hippopotamus = ฮิปโปโปเตมัส
Capybara = คาปิบารา
Sloth = สลอธ