United States = สหรัฐอเมริกา
Canada = แคนาดา
Brazil = บราซิล
Mexico = เม็กซิโก
Argentina = อาร์เจนตินา
United Kingdom = สหราชอาณาจักร
France = ฝรั่งเศส
Germany = เยอรมนี
Italy = อิตาลี
Spain = สเปน
Netherlands = เนเธอร์แลนด์
Belgium = เบลเยียม
Switzerland = สวิตเซอร์แลนด์
Sweden = สวีเดน
Norway = นอร์เวย์
Denmark = เดนมาร์ก
Finland = ฟินแลนด์
Russia = รัสเซีย
China = จีน
Japan = ญี่ปุ่น
South Korea = เกาหลีใต้
India = อินเดีย
Australia = ออสเตรเลีย
New Zealand = นิวซีแลนด์
South Africa = แอฟริกาใต้
Egypt = อียิปต์
Kenya = เคนยา
Nigeria = ไนจีเรีย
Turkey = ตุรกี
Greece = กรีซ
Saudi Arabia = ซาอุดีอาระเบีย
United Arab Emirates = สหรัฐอาหรับเอมิเรตส์
Israel = อิสราเอล
Thailand = ประเทศไทย
Singapore = สิงคโปร์
Malaysia = มาเลเซีย
Indonesia = อินโดนีเซีย
Philippines = ฟิลิปปินส์
Vietnam = เวียดนาม
Brazil = บราซิล
Portugal = โปรตุเกส
Poland = โปแลนด์
Ireland = ไอร์แลนด์
Austria = ออสเตรีย
Hungary = ฮังการี
Czech Republic = สาธารณรัฐเช็ก
South Korea = เกาหลีใต้
Pakistan = ปากีสถาน
Bangladesh = บังกลาเทศ
Greenland = กรีนแลนด์
Ukraine = ยูเครน