Avocado = อะโวคาโด
Banana = กล้วย
Canistel = ม่อนไข่
Chikoo = ละมุด
Coconut = มะพร้าว
Durian = ทุเรียน
Fig = มะเดื่อ
Grape = องุ่น
Grapefruit = ส้มโอ
Guava = ฝรั่ง
Jackfruit = ขนุน
Kiwi = ผลกีวี
Lemon = เลมอน
Longan = ลำไย
Lychee = ลิ้นจี่
Mango = มะม่วง
Mangosteen = มังคุด
Muskmelon = แตงไทย
Orange = ส้ม
Papaya = มะละกอ
Pineapple = สับปะรด
Pomegranate = ทับทิม
Rambutan = เงาะ
Starfruit = มะเฟือง
Watermelon = แตงโม
Apple = แอปเปิ้ล
Bananas = กล้วย
Blackberry = แบล็คเบอรี่
Blueberry = บลูเบอรี่
Cheery = เชอร์รี่
Clementine = ส้มคลีเมนไทน์
Cranberry = แครนเบอรี่
Date = อินทผาลัม
Grape = องุ่น
Grapefruit = ส้มโอ
Kiwi = กีวี่
Kumquat = ส้มจี๊ด
Lime = มะนาว
Mulberry = ลูกหม่อน
Pear = ลูกแพร์
Persimmon = ลูกพลับ
Pomegranat = ผลทับทิม
Pomelo = ส้มโอ
Quince = ผลควินซ์
Rambutans = เงาะ
Raspberry = ราสเบอรี่
Satsuma plum = บ๊วยญี่ปุ่น
Strawberry = สตรอวเบอรี่
Tangerine = ส้มจีน
Berry = เบอร์รี่