Chikorita = ชิกอริตะ
Bayleef = เบย์ลีฟ
Meganium = เมกะเนียม
Cyndaquil = ไซน์แดควิล
Quilava = ควิลาว่า
Typhlosion = ไทเฟลอชัน
Totodile = โทโตไดล์
Croconaw = โครโคเนา
Feraligatr = เฟอราริกาเตอร์
Sentret = เซนเทรท
Furret = เฟอร์เรท
Hoothoot = ฮูทฮุต
Noctowl = น็อกทาวล์
Ledyba = เลดีบา
Ledian = เลเดียน
Spinarak = สปินารัค
Ariados = แอเรียดอส
Crobat = โครแบต
Chinchou = ชินชู
Lanturn = แลนเทิร์น
Pichu = ปิชุ
Cleffa = เคลฟฟ่า
Igglybuff = อิกลีบัฟ
Togepi = โทเกะปิ
Togetic = โทเกติค
Natu = นาตู
Xatu = ซาตู
Mareep = มารีป
Flaaffy = ฟลาฟฟี่
Ampharos = แอมเฟรอส
Bellossom = เบลอสซอม
Marill = มาริลล์
Azumarill = อะซูมาริลล์
Sudowoodo = ซูโดวูดโด
Politoed = โปลิโตเอ็ด
Hoppip = ฮอปปิป
Skiploom = สคิปลูม
Jumpluff = จัมพลัฟ
Aipom = ไอพอม
Sunkern = ซันเคิร์น
Sunflora = ซันฟลอร่า
Yanma = ยันม่า
Wooper = วูเปอร์
Quagsire = ควากไซร์
Espeon = เอสเปียน
Umbreon = อัมเบรอน
Murkrow = มอร์คราว
Slowking = สโลว์คิง
Misdreavus = มิสเดรฟัส
Unown = อูนาวน์
Wobbuffet = วอบบัฟเฟต
Girafarig = จิราฟาริก
Pineco = ไพน์โค
Forretress = ฟอร์เรสเทรส
Dunsparce = ดันสปาร์ซ
Gligar = กลิกการ์
Steelix = สตีลิกซ์
Snubbull = สนับบล์
Granbull = แกรนบล์
Qwilfish = ควิลฟิช
Scizor = ไซเซอร์
Shuckle = ชัคเคิล
Heracross = เฮอราครอส
Sneasel = สเนสเซล
Teddiursa = เท็ดดี้เออร์ซ่า
Ursaring = อูร์ซาริง
Slugma = สลักม่า
Magcargo = แมกคาร์โก
Swinub = สวินับ
Piloswine = ไพลอสไวน์
Corsola = คอร์ซาลา
Remoraid = รีโมรอยด์
Octillery = อ็อกทิลเลอรี
Delibird = เดลิเบิร์ด
Mantine = แมนไทน์
Skarmory = สคาร์โมรี
Houndour = ฮาวน์ดัวร์
Houndoom = ฮาวน์ดุม
Kingdra = คิงดร้า
Phanpy = ฟานพี
Donphan = ดอนฟาน
Porygon2 = พอร์กิกัน 2
Stantler = สแตนท์เลอร์
Smeargle = สมียร์กล์
Tyrogue = ไทโรเกะ
Hitmontop = ฮิตมอนท็อป
Smoochum = สมูชัม
Elekid = อิเล็กคิด
Magby = แมกบี้
Miltank = มิลค์แทนค์
Blissey = บลิสซีย์
Raikou = ไรโก
Entei = เอนไท
Suicune = ซุยคูน์
Larvitar = ลาร์วิตาร์
Pupitar = พูปิตาร์
Tyranitar = ไทแรนนิทาร์
Lugia = ลูเกีย
Ho-Oh = โฮ-โอห์
