Bulbasaur = ฟุชิกิดาเนะ
Ivysaur = ฟุชิกิโซ
Venusaur = ฟุชิกิบานะ
Charmander = ฮิโตคาเงะ
Charmeleon = ลิซาร์โดะ
Charizard = ลิซาร์ดอน
Squirtle = เซนิกาเมะ
Wartortle = คาเมล
Blastoise = คาเม็กซ์
Caterpie = คาเตอร์ปี
Metapod = ทรานเซล
Butterfree = บัตเตอร์ฟรี
Weedle = บีเดิล
Kakuna = โคคูน
Beedrill = สเปียร์
Pidgey = ป็อปโปะ
Pidgeotto = พีเจียน
Pidgeot = พีเจอตโตะ
Rattata = คอร์รัตตะ
Raticate = ราติคาเตะ
Spearow = ยูโตะ
Fearow = เฟียโรว์
Ekans = เอคานส์
Arbok = อาร์บอก
Pikachu = ปิกาจู
Raichu = ไรชู
Sandshrew = ซันดัชช์
Sandslash = ซันดัชช์
Nidoran♀ = นิโดรัน♀
Nidorina = นิโดรีนา
Nidoqueen = นิโดควีน
Nidoran♂ = นิโดรัน♂
Nidorino = นิโดรีโน
Nidoking = นิโดคิง
Clefairy = เคลฟารี่
Clefable = เคลแฟเบิล
Vulpix = วัลพิกซ์
Ninetales = ไนน์เทลส์
Jigglypuff = จิกกลี่พัฟ
Wigglytuff = วิกกลี่ทัฟ
Zubat = ซูบัต
Golbat = โกลบัต
Oddish = ออดดิช
Gloom = กลูม
Vileplume = ไวล์พูล์ม
Paras = พาราส
Parasect = พาราเซ็คท์
Venonat = เวโนเนต
Venomoth = เวโนมอธ
Diglett = ดิเกล็ต
Dugtrio = ดักทริโอ
Meowth = เมียวธ์
Persian = เพอร์เซียน
Psyduck = ไซดัค
Golduck = โกลดัค
Mankey = มังกี้
Primeape = ไพรม์เอป
Growlithe = โกรว์ไลท์
Arcanine = อาร์แคนไนน์
Poliwag = โปลิวาก
Poliwhirl = โปลิไวร์ล
Poliwrath = โปลิแวร์ธ
Abra = อาบรา
Kadabra = คาดาบรา
Alakazam = อะลาคาซัม
Machop = มาโชป
Machoke = มาโช้ค
Machamp = มาแชมป์
Bellsprout = เบลล์สปราウト
Weepinbell = วีปปิ้งเบลล์
Victreebel = วิคทรีเบล
Tentacool = เทนทาคูล
Tentacruel = เทนทาครูเอล
Geodude = จิโอดูด
Graveler = แกรเวลเลอร์
Golem = โกเล็ม
Ponyta = โปนี่ตะ
Rapidash = ราปิดแอช
Slowpoke = โสโล่พ็อก
Slowbro = โสโล่โบร่
Magnemite = แม็กเนไมท์
Magneton = แม็กเนตอน
Farfetch'd = ดั๊กเล็ต
Doduo = โดดูโอ
Dodrio = โดดริโอ
Seel = ซีล
Dewgong = ดูว์กอง
Grimer = ไกรมเมอร์
Muk = มัค
Shellder = เชลเดอร์
Cloyster = คลอยสเตอร์
Gastly = แกสต์ลี่
Haunter = ฮอนเตอร์
Gengar = เก็งการ์
Onix = โอไนซ์
Drowzee = ดรอวซี่
Hypno = ฮิปโน
Krabby = คราบบี้
Kingler = คิงเลอร์
Voltorb = โวลทอร์บ
Electrode = อิเล็กโทรด
Exeggcute = เอ็กเซ็กคิวท์
Exeggutor = เอ็กเซ็กคิวเตอร์
Cubone = คิวโบน
Marowak = มารอว์วัก
Hitmonlee = ฮิตมอนลี
Hitmonchan = ฮิตมอนแชน
Lickitung = ลิคคิตัง
Koffing = คอฟฟิง
Weezing = วีซิ่ง
Rhyhorn = ไรฮอร์น
Rhydon = ไรดอน
Chansey = แชนซี
Tangela = แทนเจลา
Kangaskhan = คังคังสคาน
Horsea = ฮอร์เซีย
Seadra = ซีดร้า
Goldeen = โกลดีน
Seaking = ซีคิง
Staryu = สตารี่
Starmie = สตาร์มี
Mr. Mime = มิสเตอร์ ไมม์
Scyther = ไซเธอร์
Jynx = จิงซ์
Electabuzz = อิเล็คทราบัซ
Magmar = แม็กมาร์
Pinsir = พินเซอร์
Tauros = ทอรัส
Magikarp = แม็กคาพ
Gyarados = แกราโดส
Lapras = แลปราส
Ditto = ดิตโต้
Eevee = อีวุย
Vaporeon = แวปอเรี่ยน
Jolteon = โจลเทียน
Flareon = แฟลร์เรี่ยน
Porygon = โปริกอน
Omanyte = โอแมนไนต์
Omastar = โอมาสตาร์
Kabuto = คาบูโตะ
Kabutops = คาบูโตปส์
Aerodactyl = แอร์แด็กไทล์
Snorlax = สนอร์แล็กซ์
Articuno = อาร์ติคูโน่
Zapdos = แซพดอส
Moltres = มอลเทรส
Dratini = ดราทินี่
Dragonair = ดรากอนแอร์
Dragonite = ดรากอนไนท์
Mewtwo = มิวทู
Mew = มิว
