Sport = กีฬา
Badminton = แบดมินตัน
Baseball = เบสบอล
Basketball = บาสเก็ทบอล
Bowling = โบว์ลิ่ง
Football = ฟุตบอล
Golf = กอล์ฟ
Rugby = รักบี้
Tennis = เทนนิส
Volleyball = วอลเลย์บอล
Archery = ยิงธนู
Athletics = กรีฑา
Boxing = ต่อยมวย
Cricket = คริกเก็ต
Cycling	= ปั่นจักรยาน
Darts = ปาเป้า
Fencing = ฟันดาบ
Fishing = ตกปลา
Gymnastics = ยิมนาสติก
Handball = แฮนด์บอล
Hockey = ฮอกกี้
Judo = ยูโด
Polo = โปโล
Karate = คาราเต้
Running	= วิ่งแข่ง
Sailing	= แข่งเรือใบ
Softball = ซอฟต์บอล
Shooting = ยิงปืน
Skateboarding = สเกตบอร์ด
Skating = สเกต
Skiing = สกี
Sqaush = สควอช
Snooker = สนุกเกอร์
Snowboarding = สโนว์บอร์ด
Swimming = ว่ายน้ำ
Taekwondo = เทควันโด
Wrestling = มวยปล้ำ
Surfing = กีฬาโต้คลื่น
Rowing = การพายเรือ
Marathon = วิ่งมาราธอน
Hiking = เดินป่า
Canoeing = พายเรือแคนู
Aerobics = แอโรบิก
Winner = ผู้ชนะ
Loser = ผู้แพ้
Opponent = ฝ่ายตรงข้าม
Spectator = ผู้ชม
Defeat = พ่ายแพ้
Referee = กรรมการ
Injury = บาดเจ็บ